1111111111111111111111111
110000100011000000101C101
1111011001110000000011101
1101000000000100000001001
1111111110110000011100001
1100000000110000011101111
1111011111111101110000001
1111011111111101110101001
1100000011010101110001111
11000100000100001100000E1
1100000000000000110101111
110000P111010101111101111
1111111111111111111110111
