11111111111111111111111111111111111111111111111111111111
10010000000000000000000000000000000000000000000000000011
100100000CCCCC000000000000000000000000000000000000000011
1001000000C0C1000000000000000000000000000000000000000001
10000111110001100000000000000000000000000000000000000001
100001C0000110000000000000000000000000000000000000000011
1000011111100E000000000000000000000000000000000000000001
10P10100000C00000000000000000000000000000000000000000011
11111111111111111111111111111111111111111111111111111111
