1111111111111111111111111
11000000001100000001000C1
11110C000111C000C00000001
110100000000000000000C001
1111111110110000011100001
1100000000110000011101111
1111011111111101110000001
1111011111111101110100001
1100000011010101110001111
11000C00000C00001100000E1
1100000000000001100001111
110000P111010101111101111
1111111111111111111111111
