11111111111111111
100100000000000C1
100100000CCCCC0C1
1001000000C0C10C1
10000111110000001
100001E0000000001
10000111110000001
10P10100000000011
11111111111111111
