11111111111111111
100100000000001C1
100100000CCCCC1C1
1001000000C0C00C1
10000111110001101
100001C0000010011
1000011111100E001
10P10100000C00011
11111111111111111
