11111111111111111
110C0000000100001
11010000E00000C01
11P10000000100001
11111111111111111
