11111111111111111111111111
1P0000000000001C0001C10001
100000000000000C0001000001
1000E00000C0001C0000010001
11111111111111111111111111
