11111111111
11CC0010001
11E10000C01
11P11000011
11111111111
